!!!!!!!!""""!!!!!!!!
!!!!!!!!""""!!!!!!!!
!!#"""""$""""#"""""!
!!"""""""""""""""""!
!!"""""""""""""""""!
!!"""""""""""""""""!
!!"""""""""""""""""!
!!"""""""""""""""""!
"""$""""$""""$""""""
""""""""""""""""""""
""""""""""""""""""""
""""""""""""""""""""
!!"""""""""""""""""!
!!#"""""$""""#"""""!
!!"""""""""""""""""!
!!"""""""""""""""""!
!!"""""""""""""""""!
!!"""""""""""""""""!
!!"""""""""""""""""!
!!!!!!!!""""!!!!!!!!

!!!!!!!!!!!!!!!!!!!!
!!!!!!!!!!!!!!!!!!!!
!!!!!!!!!!!!!!!!!!!!
!!!!!!!!!!!!!!!!!!!!
!!!!!!!!!!!!!!!!!!!!
!!!!!!!!!!!!!!!!!!!!
!!!!!!!!!!!!!!!!!!!!
!!!!!!!!!!!!!!!!!!!!
!!!!!!!!!!!!!!!!!!!!
!!!!!!!!!!!!!!!!!!!!
!!!!!!!!!!!!!!!!!!!!
!!!!!!!!!!!!!!!!!!!!
!!!!!!!!!!!!!!!!!!!!
!!!!!!!!!!!!!!!!!!!!
!!!!!!!!!!!!!!!!!!!!
!!!!!!!!!!!!!!!!!!!!
!!!!!!!!!!!!!!!!!!!!
!!!!!!!!!!!!!!!!!!!!
!!!!!!!!!!!!!!!!!!!!
!!!!!!!!!!!!!!!!!!!!
